[FRESH MUSIC FRIDAY]

Here are the albums, singles, and videos (to older songs) that dropped this week.

If you've releasing some music, or know someone who is and want it included in this post, please do DM me! Otherwise feel free to drop it in the comments.

[ALBUMS]
Tory Lanez - The New Toronto 3
Bladee - EXETER
Knxwledge - MEEK.VOL6
22Gz - Growth & Development
Serengeti & Kenny Segal - Ajai
Kiana Ledé - KIKI
2KBABY- Pregame Rituals
Manga Saint Hilare - Make It Out Alive
24hrs & DJ Drama - 12 AM in Atlanta 2
Troyman - Insomniac
Grip - Halo
JP THE WAVY - Life is Wavy
Apashe - Renaissance (w/ feats from Wifisfuneral, Tech N9ne, High Klassified and more)
Chuuwee, Trizz - 3.5(Eighth)
Gorilla Zoe - 31 DAYS OF COVID-19
GAWVI - Heathen
[FRESH Album] Cadet - The Rated Legend
VANILLA RICE - The Vanilla Rice Tapes: Vol.1
FMB DZ - The Gift 3

[SINGLES]
Gorillaz - Aries (feat. Peter Hook & Georgia) [Episode Three]
Rich Brian - Bali ft. Guapdad 4000
IDK - In My White Tee
RMR - Dealer
Polo G - DND
Ramin Dijwadi - Wicked Games (Weeknd cover from Westworld: Season 3)
Jean Deaux feat. Saba - Moody!
Usher, Lil Jon & Ludacris - SexBeat
dvsn & Ty Dolla $ign - Dangerous City (feat. Buju Banton)
Machine Gun Kelly - What’s Poppin Freestyle
idontknowjeffery - Ask About Me (Live) | UPROXX Sessions
RZA - Guided Explorations
Leon Bridges - Inside Friend (feat. John Mayer)
1TakeJay - Fucked Up
Kevin Gates - Wetty (Freestyle)
Jon Connor - The Pain
Yella Beezy - Headlocc (feat. Young Thug)
Pink Siifu - ,NEGRO
Asher Roth - Hunnid (Feat. Joyce Wrice)
Aesop Rock - KOWP
UnoTheActivist - Night Mode
Swavay - Selena Gomez (feat. Erick the Architect)
Quadeca - WHERE’D YOU GO
Retch - Whip Out (feat. Slayter)
Tory Lanez - Stupid Again
Cookin Soul - Toosie
100 gecs - gec 2 u (Remix) Feat. Dorian Electra
Buddy & Kent Jamz - She Think
Skyzoo & Dumbo Station - Good Enough Reasons
ICECOLDBISHOP - PUSH TO START (Freestyle)
UnoTheActivist - Night Mode (feat.2gramcam)
ALLBLACK - Chevron 2
Mozzy - Pricetag ft. Polo G, Lil Poppa
nba youngboy - step on shit
Kirby Tuckett - Work from Home
Lady Leshurr - Quarantine Speech
Father - Lynch Mob (feat. SEANTHOMMONEY)
ESO (of CZARFACE) - Stir Crazy
Sadistik - Delirium EP
Cousin Stizz - Vendetta
Mez - Gundam Freestyle 001 / Gundam Freestyle 002
TIMO - Pulling Out the Splinters
Joe Moses - Cheat Code Mode (feat. Young Thug, Eric Bellinger, Nieman J)
RZA - Bite or Stop Barking
Kemba - Pisces
Jackboy - Cleaning Crew (NBA Youngboy diss)
Zeroh - The Lord & Nature
Exile - I Wish You Love
YGTUT - Chattanooga Vendetta
Diamondsonmydick x SMOKEPURRP x STUNNY - EAT!
Young Chop - Niggas Salty
Tory Lanez - Accidents Happen (with Lil Tjay)
Z-Ro - Life of the Party ft. Boosie Badazz
Tech N9ne - Just Die?
Lil Uzi Vert - Pet (HQ Remaster)
Shy Glizzy - Lonely Vibes [Official Audio]
Young Chop - Movie
Webby Dean - Covid
Levi Ryan - Upstate
Ben Levin - FAKE Guitar Hip Hop

[VIDEOS]
The Weeknd - Until I Bleed Out
Smino - Reverend
JPEGMAFIA - HTBAR 5
JME - ISSMAD
Ari Lennox - BUSSIT
Anderson .Paak, Justin Timberlake - Don't Slack
BlocBoy JB “Out West” Freestyle
Rico Nasty - Popstar
Youngboy Never Broke Again - AI Nash (Dir. by @_ColeBennett_)
Lil Gotit - Bricks In The Attic
IDK - In My White Tee
K.A.A.N. ft Blu - Simonal
KILLY - VV's ft. Houdini & 6ixBuzz
tobi lou — Skin Care Tutorial 2020
Zelooperz - JayJay-Z // Bigger Than Me (Kinda Neat)
Grafh Ft. Royce Da 5’9 - Agenda
L-Zee Roselli - Anxiety (City Morgue vibes but from London)
Sheff G - MOODY
BLACK KRAY AKA SICKBOYRARI ☆☆ AOK - SLAYIN
YUNG MAL - “GOIN UP”
Stack Skrilla - Stoned Sober
Lady Leshurr - Quarantine Speech
